8 53 0 0 0 0 0 0 0 0 0 0 0 0 0 0 0 0 0 0 0 0 0 0 60 61 59 59 37 59 59 59 59 59 59 59 59 59 59 37 37 59 59 59 59 52 53 0 0 0 0 0 0 0 0 0 0 0 0 0 0 0 0 0 0 0 0 0 0 0 0 0 0 0 0 0 0 0 0 0 0 0 0 0 0 0 0 0 0 0 0 0 0 0 44 45 10 10 10 10 10 4 4 10 10 10 10 10 4 4 4 10 4 4 10 10 10 10 10 10 10 10 10 10 10 10 10 10 10 10 10 10 10 10 10 12 10 10 10 10 41 43 0 0 0 0 0 0 0 0 0 0 0 0 0 0 0 0 0 0 0 0 0 0 0 0 0 0 0 0 0 0 0 0 0 0 0 0 0 0 0 0 0 0 0 0 0 0 0 0 0 0 0 0 0 0 0 0 0 0 0 0 0 0 0 0 0 0 0 0 0 0 0 0 0 0 0 0 0 0 0 0 0 0 0 0 0 0 0 0 0 0 0 0 0 0 0 0 0 0 0 0 0 0 0 0 0 0 44 45 10 10 10 10 10 10 10 10 10 10 10 10 10 10 10 12 10 10 10 41 43 0 0 0 0 0 0 0 0 0 0 0 0 0 0 0 0 0 0 0 0 0 0 0 0 0 0 0 0 0 0 0 0 0 0 0 0 0 0 0 0 0 0 0 0 0 0 0 0 0 0 0 0 0 0 0 0 0 0 0 0 0 0 0 0 0 0 0 0 0 0 0 0 0 0 0 0 0 0 0 0 0 0 0 0 0 0 0 0 0 0 0 0 44 45 10 10 10 10 10 10 10 10 10 10 10 10 10 10 10 10 10 10 10 10 10 10 10 10 10 10 10 10 10 10 10 10 10 10 10 
16 52 53 0 0 0 0 0 0 0 0 0 0 0 0 0 0 0 0 0 0 0 0 60 61 59 59 59 59 59 59 59 59 37 59 59 59 59 59 59 59 59 37 59 37 59 6 7 85 7 47 7 7 85 7 47 7 7 85 7 47 47 7 7 85 85 7 7 7 7 7 7 85 7 7 47 7 7 7 85 47 7 7 8 0 0 0 0 0 0 0 0 0 0 0 44 45 10 10 10 10 4 10 10 10 10 10 10 10 10 10 10 4 4 10 10 10 10 10 10 10 10 10 10 10 10 10 10 10 10 10 10 10 10 10 4 10 10 10 41 43 0 0 0 0 0 0 0 0 0 0 0 0 0 0 0 0 0 0 0 0 0 0 0 0 0 0 0 0 0 0 0 0 0 0 0 0 0 0 0 0 0 0 0 0 0 0 0 0 0 0 0 0 0 0 0 0 0 0 0 0 0 0 0 0 0 0 0 0 0 0 0 0 0 0 0 0 0 0 0 0 0 0 0 0 0 0 0 0 0 0 0 0 0 0 0 0 0 0 0 0 0 0 0 0 0 0 0 0 44 45 10 10 12 10 10 12 10 10 10 10 10 10 10 10 12 10 10 41 43 0 0 0 0 0 0 0 0 0 0 0 0 0 0 0 0 0 0 0 0 0 0 0 0 0 0 0 0 0 0 0 0 0 0 0 0 0 0 0 0 0 0 0 0 0 0 0 0 0 0 0 0 0 0 0 0 0 0 0 0 0 0 0 0 0 0 0 0 0 0 0 0 0 0 0 0 0 0 0 0 0 0 0 0 0 0 0 0 0 0 0 0 0 0 44 45 10 10 10 12 10 10 10 10 10 10 4 4 10 10 10 10 10 10 10 10 10 10 12 12 12 12 10 10 10 10 10 10 10 10 
16 59 52 53 0 0 0 0 0 0 0 0 0 0 0 0 0 0 0 0 0 0 60 61 59 59 59 59 59 37 59 59 59 59 59 59 59 59 37 59 59 59 59 59 59 59 16 49 86 59 48 59 59 86 59 48 37 59 86 59 48 48 59 59 86 86 59 59 59 59 59 59 86 59 59 48 37 59 37 86 48 37 59 16 0 0 0 0 0 0 0 0 0 0 0 0 44 18 45 10 10 10 10 10 10 10 10 10 10 10 10 10 10 10 10 12 4 4 4 4 4 10 12 12 10 10 10 10 10 10 10 10 10 10 10 10 10 10 41 43 0 0 0 0 0 0 0 0 0 0 0 0 0 0 0 0 0 0 0 0 0 0 0 0 0 0 0 0 0 0 0 0 0 0 0 0 0 0 0 0 0 0 0 0 0 0 0 0 0 0 0 0 0 0 0 0 0 0 0 0 0 0 0 0 0 0 0 0 0 0 0 0 0 0 0 0 0 0 0 0 0 0 0 0 0 0 0 0 0 0 0 0 0 0 0 0 0 0 0 0 0 0 0 0 0 0 0 0 0 0 44 45 10 10 10 10 10 10 10 10 12 12 12 10 12 12 10 41 43 0 0 0 0 0 0 0 0 0 0 0 0 0 0 0 0 0 0 0 0 0 0 0 0 0 0 0 0 0 0 0 0 0 0 0 0 0 0 0 0 0 0 0 0 0 0 0 0 0 0 0 0 0 0 0 0 0 0 0 0 0 0 0 0 0 0 0 0 0 0 0 0 0 0 0 0 0 0 0 0 0 0 0 0 0 0 0 0 0 0 0 0 0 0 0 0 44 45 10 10 10 10 10 10 10 10 10 10 10 10 10 10 12 12 10 10 10 10 10 10 10 10 10 10 10 10 4 10 10 10 10 
16 59 59 54 0 0 0 0 0 0 0 0 0 0 0 0 0 0 0 0 0 0 6 7 7 7 7 7 7 7 7 7 7 7 7 7 7 7 7 7 7 7 7 7 7 7 24 59 59 37 37 59 59 59 37 59 59 59 59 59 59 59 59 59 59 59 59 59 59 59 59 59 59 59 59 59 59 59 59 59 59 59 37 16 0 0 0 0 0 0 0 0 0 0 0 0 0 0 44 45 10 10 4 10 10 12 10 10 10 10 10 4 4 10 12 12 4 4 10 10 10 10 10 4 4 4 4 4 10 10 10 10 12 4 4 10 10 41 43 0 0 0 0 0 0 0 0 0 0 0 0 0 0 0 0 0 0 0 0 0 0 0 0 0 0 0 0 0 0 0 0 0 0 0 0 0 0 0 0 0 0 0 0 0 0 0 0 0 0 0 0 0 0 0 0 0 0 0 0 0 0 0 0 0 0 0 0 0 0 0 0 0 0 0 0 0 0 0 0 0 0 0 0 0 0 0 0 0 0 0 0 0 0 0 0 0 0 0 0 0 0 0 0 0 0 0 0 0 0 0 0 44 18 18 18 18 18 18 10 10 12 12 10 10 12 12 41 43 0 0 0 0 0 0 0 0 0 0 0 0 0 0 0 0 0 0 0 0 0 0 0 0 0 0 0 0 0 0 0 0 0 0 0 0 0 0 0 0 0 0 0 0 0 0 0 0 0 0 0 0 0 0 0 0 0 0 0 0 0 0 0 0 0 0 0 0 0 0 0 0 0 0 0 0 0 0 0 0 0 0 0 0 0 0 0 0 0 0 0 0 0 0 0 0 0 0 44 45 10 10 10 10 10 12 12 10 10 10 10 10 10 12 12 10 10 10 10 10 10 10 10 10 10 10 10 10 10 10 10 10 
16 37 59 52 53 0 0 0 0 0 0 0 0 0 0 0 0 0 0 0 0 0 16 69 70 87 88 87 88 87 88 87 88 87 88 87 88 87 88 69 70 59 59 59 59 59 14 59 59 59 59 59 59 59 59 59 59 59 59 59 59 59 59 59 59 59 59 59 59 59 59 59 59 59 59 59 59 59 59 59 59 59 59 16 0 0 0 0 0 0 0 0 0 0 0 0 0 0 0 44 45 10 10 10 10 10 10 10 10 10 10 10 10 10 10 10 10 10 10 10 10 10 10 10 10 4 4 12 10 10 10 10 12 4 4 10 41 43 0 0 0 0 0 0 0 0 0 0 0 0 0 0 0 0 0 0 0 0 0 0 0 0 0 0 0 0 0 0 0 0 0 0 0 0 0 0 0 0 0 0 0 0 0 0 0 0 0 0 0 0 0 0 0 0 0 0 65 66 67 0 0 0 0 65 66 67 0 0 0 0 93 0 0 65 66 67 0 0 0 0 0 0 0 0 0 0 0 0 0 0 0 0 0 0 0 0 0 0 0 0 0 0 0 0 0 0 0 0 0 0 0 0 0 0 0 0 0 0 44 45 12 12 10 10 10 41 43 0 0 0 0 0 0 0 0 0 0 0 0 0 0 0 0 0 0 0 0 0 0 0 0 0 0 0 0 0 0 0 0 0 0 0 0 0 0 0 0 0 0 0 0 0 0 0 0 0 89 0 0 0 0 0 0 0 0 0 0 0 0 0 0 0 0 0 0 0 0 0 0 0 0 0 0 0 0 0 0 0 0 0 0 0 0 0 0 0 0 0 0 0 0 0 0 0 0 0 0 44 45 10 10 10 10 4 12 10 10 10 10 10 10 10 10 10 10 12 10 10 41 18 18 45 10 10 10 10 10 4 10 10 
16 59 59 59 52 53 0 0 0 0 0 0 0 0 0 0 0 0 0 0 0 60 16 77 78 84 84 84 84 84 84 84 84 84 84 84 84 84 84 77 78 59 59 59 59 59 14 59 59 59 59 59 59 59 59 59 59 59 59 59 59 59 59 59 59 59 59 59 59 59 59 59 59 59 59 59 59 59 59 59 59 59 59 16 0 0 0 0 0 0 0 0 0 0 0 0 0 0 0 0 44 45 10 10 10 10 10 10 10 10 10 10 10 10 10 10 10 41 18 45 10 10 10 10 10 10 10 10 10 10 10 12 12 10 10 41 43 0 0 0 0 0 0 0 0 0 0 0 0 0 0 0 0 0 0 0 0 0 0 0 0 0 0 0 0 0 0 0 0 0 0 0 0 0 0 0 0 0 0 0 0 0 0 0 0 0 0 0 0 90 0 0 0 0 0 0 73 74 75 13 89 13 13 73 74 75 13 0 13 57 20 0 5 73 74 75 0 0 0 0 0 13 13 33 5 5 33 0 0 0 0 0 0 0 0 0 0 0 0 0 0 0 0 0 0 0 0 0 0 0 0 0 0 0 0 0 0 0 0 44 18 18 18 18 18 43 0 0 0 0 0 0 0 0 0 0 0 0 0 0 0 0 0 0 0 0 0 0 0 0 0 0 0 0 0 0 0 0 0 0 0 0 0 0 0 0 0 0 0 0 0 0 13 0 5 5 31 13 68 13 5 13 0 0 0 0 0 0 0 0 0 0 0 0 0 0 0 0 0 0 0 0 0 0 0 0 0 0 0 0 0 0 0 0 0 0 0 0 0 0 0 0 0 0 0 0 0 0 44 45 10 10 4 4 10 10 12 12 10 10 10 10 10 10 10 10 10 41 43 76 76 44 45 10 10 10 10 4 10 10 
16 59 59 59 59 54 0 0 0 0 0 0 0 0 0 0 0 0 0 0 60 61 16 69 70 59 59 59 59 59 59 59 59 59 59 59 59 59 59 69 70 59 59 59 59 59 22 23 23 23 23 23 23 23 23 23 23 23 23 23 23 23 23 23 23 23 23 23 23 23 23 23 23 23 23 23 23 23 23 23 23 23 23 24 0 0 0 0 0 0 0 0 0 0 0 0 0 0 0 0 0 44 18 45 10 10 12 4 4 10 10 12 10 10 10 10 41 42 0 44 45 10 10 10 10 12 10 10 10 10 10 12 12 10 41 43 0 0 0 0 0 0 0 0 0 0 0 0 0 0 0 0 0 0 0 0 0 0 0 0 0 0 0 0 0 0 0 0 0 0 0 0 0 0 0 0 0 0 0 0 0 0 0 0 0 0 0 0 0 28 0 0 0 27 28 28 28 28 28 28 28 28 28 28 28 28 28 28 28 28 28 28 28 28 28 28 29 0 0 0 27 28 28 28 28 28 28 29 0 0 0 0 0 0 0 0 0 0 0 0 0 0 0 0 0 0 0 0 0 0 0 0 0 0 0 0 0 0 0 0 0 0 0 0 0 0 0 0 0 0 0 0 0 0 0 0 0 0 0 0 0 0 0 0 0 0 0 0 0 0 0 0 0 0 0 0 0 0 0 0 0 0 0 0 0 0 0 0 0 0 0 0 27 28 28 28 28 28 28 28 28 28 29 0 0 0 0 0 0 0 0 0 0 0 0 0 0 0 0 0 0 0 0 0 0 0 0 0 0 0 0 0 0 0 0 0 0 0 0 0 0 0 0 0 0 0 0 0 0 44 45 10 4 4 10 10 10 10 10 10 10 12 12 4 4 10 41 43 0 0 0 0 44 45 10 10 10 10 10 10 
16 59 59 37 59 54 0 0 0 0 0 0 0 0 0 0 0 0 0 0 58 59 16 77 78 84 84 84 84 84 84 84 84 84 84 84 84 84 84 77 78 59 59 59 59 59 59 59 59 59 59 59 86 86 86 86 86 86 86 86 86 86 86 86 86 86 86 86 86 86 86 86 86 86 86 86 86 86 86 86 86 86 86 59 0 0 0 0 0 0 0 0 0 0 0 0 0 0 0 0 0 0 0 44 45 10 10 10 10 10 10 10 10 10 10 41 42 0 0 0 44 45 10 10 10 10 10 10 10 10 10 10 10 41 43 0 0 0 0 0 0 0 0 0 0 0 0 0 0 0 0 0 0 0 0 0 0 0 0 0 0 0 0 0 0 0 0 0 0 0 0 0 0 0 0 0 0 0 0 0 0 0 0 90 0 0 28 0 0 0 0 0 0 0 44 45 10 10 10 10 10 10 10 10 10 4 4 10 10 10 12 12 10 10 41 43 0 0 0 0 0 63 64 59 59 49 50 0 0 0 0 0 0 33 33 13 5 93 13 93 33 5 0 33 0 0 0 0 0 0 0 0 0 0 0 0 0 0 0 0 0 0 0 0 0 0 0 0 0 0 0 0 0 0 0 0 0 0 0 0 0 0 0 0 0 0 0 0 0 0 0 0 0 0 0 0 0 0 0 0 0 0 0 0 0 0 0 0 0 0 0 0 0 76 76 76 76 76 76 76 76 76 0 0 20 0 0 0 0 0 0 0 0 0 0 0 0 0 0 0 0 0 0 0 0 0 0 0 0 0 0 0 0 0 0 0 0 0 0 0 0 0 0 0 0 0 0 0 0 0 44 45 10 10 10 10 10 10 4 4 10 12 12 10 10 41 43 0 0 0 0 0 0 44 45 10 10 4 4 12 
16 59 59 59 59 52 53 0 0 0 0 0 0 0 0 0 0 0 0 0 58 59 16 69 70 59 39 59 39 39 59 59 59 39 39 59 59 39 59 69 70 59 59 59 59 59 59 59 59 59 59 59 59 59 59 59 59 59 59 59 59 59 59 59 59 59 59 59 59 59 59 59 59 59 59 59 59 59 59 59 59 59 59 59 0 0 0 0 0 0 0 0 0 0 0 0 0 0 0 0 0 0 0 0 44 18 18 18 18 18 18 18 18 18 18 42 0 0 0 0 0 44 18 18 18 18 18 18 18 18 18 18 18 43 0 0 0 0 0 0 0 0 0 0 0 0 0 0 0 0 0 0 0 0 0 0 0 0 0 0 0 0 0 0 0 0 0 0 0 0 0 0 0 0 93 0 0 0 0 0 0 0 0 28 0 0 0 0 0 0 0 0 0 0 0 44 45 10 10 12 10 10 4 10 10 10 10 10 10 4 10 10 10 41 43 0 0 0 0 0 0 0 58 59 37 51 0 0 0 0 0 0 27 28 28 28 28 28 28 28 28 28 28 29 0 0 0 0 0 0 0 0 0 0 0 0 0 0 0 0 0 0 0 0 0 0 0 0 0 0 0 0 0 0 0 0 0 0 0 0 0 0 0 0 0 0 0 0 0 0 0 0 0 0 0 0 0 0 0 0 0 0 0 0 0 0 0 0 0 0 0 0 0 0 0 0 0 0 0 0 0 0 0 0 0 0 0 0 0 0 0 0 0 0 0 0 0 0 0 0 0 0 0 0 0 0 0 0 0 0 0 0 0 0 0 0 0 0 0 0 0 0 0 0 0 0 0 0 0 0 0 44 18 18 18 18 18 18 18 18 18 18 18 18 18 43 0 0 0 0 0 0 0 0 44 45 10 4 12 4 
16 59 59 59 59 59 52 53 0 0 0 0 0 0 0 0 0 0 0 60 58 59 16 77 78 87 88 87 88 87 88 87 88 87 88 87 88 87 88 77 78 59 59 59 59 59 59 59 59 59 59 59 59 59 59 59 59 59 59 59 59 59 59 59 59 59 59 59 59 59 59 59 59 59 59 59 59 59 59 59 59 59 59 59 0 0 0 0 0 0 0 0 0 0 0 0 0 0 0 0 0 0 0 0 0 0 0 0 0 0 0 0 0 0 0 0 0 0 0 0 0 0 0 0 0 0 0 0 0 0 0 0 0 0 0 0 0 0 0 0 0 0 0 0 0 0 0 0 0 0 0 0 0 0 0 0 0 0 0 0 0 0 0 0 0 0 0 0 0 0 0 0 0 0 27 29 0 0 27 29 0 0 0 0 0 0 0 0 0 0 0 0 0 0 0 0 44 45 10 10 10 10 10 10 10 10 10 10 10 4 10 10 41 43 0 0 0 0 0 0 0 60 61 37 59 52 53 0 0 0 0 0 0 63 64 37 59 59 59 59 59 37 59 53 0 0 0 0 0 0 0 0 0 0 0 0 0 0 0 0 0 0 0 0 0 0 0 0 0 0 0 0 0 0 90 0 0 0 0 0 0 0 0 0 0 0 0 0 0 0 0 0 0 0 0 0 0 0 0 0 0 0 0 0 0 0 0 0 0 0 0 0 0 0 0 0 0 0 0 0 0 0 0 0 0 0 0 0 20 0 0 0 0 0 0 0 0 0 0 0 0 0 0 0 0 0 0 0 0 0 0 0 0 0 0 0 0 0 0 0 0 0 0 0 0 0 0 0 0 0 0 0 0 76 76 76 76 76 76 76 76 76 76 76 0 0 0 0 0 0 0 0 0 0 0 44 45 10 10 4 
16 59 59 59 37 59 59 52 53 0 0 0 0 0 0 0 0 0 60 61 59 37 16 86 86 59 59 86 59 86 59 59 86 86 59 86 59 86 59 59 86 59 59 59 59 59 59 59 59 59 59 59 59 59 59 59 59 59 59 59 59 59 59 59 59 59 59 59 59 59 59 59 59 59 59 59 59 59 59 59 59 59 59 59 0 0 0 0 0 0 0 0 0 0 0 0 0 0 0 0 0 0 0 0 0 0 0 0 0 0 0 0 0 0 0 0 0 0 0 0 0 0 0 0 0 0 0 0 0 0 0 0 0 0 0 0 0 0 0 0 0 0 0 0 0 0 0 0 0 0 0 0 0 0 0 0 0 0 0 0 0 0 0 0 0 0 0 0 0 0 27 29 0 0 0 0 0 0 0 0 0 0 0 0 0 0 0 0 0 0 0 0 0 0 0 0 0 44 45 10 10 10 10 10 12 10 12 10 10 10 10 41 43 0 0 0 0 0 0 0 0 62 59 59 59 37 54 0 0 0 0 0 0 0 58 59 37 59 59 59 37 37 37 54 0 0 0 0 0 0 0 0 0 0 0 0 0 0 0 0 0 0 0 0 0 0 0 0 0 0 0 0 0 0 0 0 0 0 0 0 0 0 0 0 0 0 0 0 0 0 0 0 0 0 0 0 0 0 0 0 0 0 0 0 0 0 0 0 0 0 0 0 0 0 0 0 0 0 0 0 0 0 0 0 90 90 0 0 0 0 0 0 0 0 0 0 0 0 0 0 0 0 0 0 0 0 0 90 0 0 0 0 0 0 0 90 0 0 0 20 0 0 0 0 0 0 0 0 0 0 0 0 0 0 0 0 0 0 0 0 0 0 0 0 0 0 0 0 0 0 0 0 0 0 0 0 44 18 18 18 
16 59 59 59 59 59 37 37 52 53 0 0 0 0 0 0 0 0 62 59 59 59 16 59 37 59 59 59 59 59 59 59 59 59 59 59 59 59 37 59 59 59 59 59 59 59 59 59 59 59 59 59 59 59 59 59 59 59 59 59 59 59 59 59 59 59 59 59 59 59 59 59 59 59 59 59 59 59 59 59 59 59 59 59 0 0 0 0 0 0 0 0 0 0 0 0 0 0 0 0 0 0 0 0 0 0 0 0 0 0 0 0 0 0 0 0 0 0 0 0 0 0 0 0 0 0 0 0 0 0 0 0 0 0 0 0 0 0 0 0 0 0 0 0 0 0 0 0 0 0 0 0 0 0 0 0 0 0 0 0 0 0 0 0 0 0 0 0 0 0 0 0 0 0 0 0 0 0 0 0 0 0 0 0 0 0 0 0 0 0 0 0 0 0 0 0 0 0 44 4 10 10 4 4 10 10 4 10 10 4 41 43 0 0 0 0 0 0 0 0 33 62 59 59 59 59 51 57 57 89 0 93 93 60 61 59 59 59 59 59 37 37 37 52 53 33 0 0 13 33 0 13 13 13 33 0 5 33 0 0 33 0 0 0 0 0 0 0 0 65 66 67 0 0 0 0 0 65 66 67 0 0 0 0 0 0 0 0 0 0 0 0 0 0 0 0 0 0 0 0 0 0 0 0 0 0 0 0 0 65 66 67 65 66 67 0 0 0 0 0 0 0 0 0 71 72 0 0 0 0 0 0 0 0 0 0 0 0 0 0 0 0 0 0 0 0 0 20 0 0 0 0 0 0 0 20 0 0 0 0 0 0 90 0 0 0 0 0 0 0 0 0 0 0 0 0 0 0 0 0 0 0 0 0 0 0 0 0 0 0 0 0 0 0 0 0 0 76 76 76 
16 59 59 37 59 59 59 59 59 52 53 0 68 68 68 68 0 60 61 37 37 59 16 59 59 59 59 37 37 59 59 59 59 59 59 37 59 59 59 59 59 59 59 59 59 59 59 59 59 59 59 59 59 59 59 59 59 59 92 92 59 59 59 59 59 59 59 59 59 59 59 59 59 59 59 59 59 59 59 59 59 59 59 59 0 0 0 0 0 0 0 0 0 0 0 0 0 0 0 0 0 0 0 0 0 0 0 0 0 0 0 0 0 0 0 0 93 0 0 0 0 0 0 0 0 0 0 0 0 0 0 0 0 0 0 0 0 0 0 0 0 0 0 0 0 0 0 0 0 0 0 0 0 0 0 0 0 0 0 0 0 0 0 0 0 0 27 29 0 0 0 0 0 0 0 0 0 0 0 0 0 0 0 0 0 0 0 0 0 0 0 0 0 0 0 0 0 0 0 44 18 18 18 18 18 18 18 18 18 18 43 0 0 0 0 0 0 0 0 0 1 2 2 2 2 2 2 2 2 2 2 2 2 2 2 2 2 2 2 2 2 2 2 2 2 2 2 2 2 2 2 2 2 2 2 2 2 2 2 2 2 2 3 0 0 0 0 33 33 73 74 75 90 13 13 5 90 73 74 75 33 0 0 33 25 0 0 0 0 0 57 0 0 0 0 0 57 90 0 0 90 0 0 0 0 0 0 25 0 73 74 75 73 74 75 57 57 57 13 13 0 0 0 0 79 80 0 0 0 57 57 20 0 0 0 0 0 0 0 0 0 0 0 20 0 0 0 0 0 0 0 20 0 0 0 0 0 0 0 0 0 0 20 0 0 0 0 0 0 0 0 0 0 0 0 0 0 0 0 0 0 0 0 0 0 0 0 0 0 0 0 0 0 0 0 0 0 0 0 0 
24 22 7 7 7 7 7 7 7 7 7 7 7 7 7 7 7 7 7 7 7 7 24 59 59 59 59 59 59 59 59 59 59 59 59 59 59 59 37 59 59 59 59 59 59 59 59 59 59 59 59 59 59 59 59 59 59 92 71 72 92 59 59 59 59 59 59 59 59 59 59 59 59 59 59 59 59 59 59 59 59 59 59 59 0 0 0 0 0 0 0 0 0 0 0 0 0 0 0 0 0 0 65 66 67 0 0 0 0 0 0 65 66 67 0 0 71 72 0 0 0 0 0 0 0 0 0 0 0 0 0 0 0 0 0 0 0 0 0 0 0 0 0 0 0 0 0 0 0 0 0 0 0 0 0 0 0 0 0 0 0 0 0 0 0 0 0 0 0 0 0 0 0 0 0 0 0 0 0 0 0 0 0 0 0 0 0 0 0 0 0 0 0 0 0 0 0 0 0 0 0 0 0 0 0 0 0 0 0 0 0 0 0 0 0 0 0 0 89 0 44 45 4 4 10 10 10 10 10 10 10 10 10 10 10 10 10 10 10 10 4 10 10 10 10 10 10 10 10 10 10 10 10 10 10 10 10 10 10 10 10 41 43 0 0 0 0 1 2 2 2 2 2 2 2 2 2 2 2 2 2 2 2 2 3 26 26 0 0 26 26 26 0 0 0 26 26 26 0 26 26 0 0 26 0 0 26 1 2 2 2 2 2 21 21 21 21 21 21 21 21 21 21 21 21 21 21 21 21 21 21 21 2 2 2 3 0 0 0 20 0 0 0 0 0 0 0 0 0 0 0 0 0 0 0 0 0 0 0 0 0 0 0 0 0 0 0 0 0 0 0 0 33 33 13 5 90 90 0 33 5 0 33 0 0 0 0 0 0 0 0 0 0 0 0 0 0 0 0 0 
87 88 59 86 59 48 86 87 88 48 48 59 86 87 88 48 59 86 86 59 59 59 59 59 59 59 59 59 59 59 59 59 59 59 59 59 59 59 59 59 59 59 59 59 59 59 59 59 59 59 59 59 59 59 59 59 39 20 79 80 20 59 59 59 59 59 59 59 59 59 59 59 59 59 59 59 59 59 59 59 59 59 59 59 0 25 0 0 0 93 0 93 0 93 0 0 25 0 0 0 0 33 73 74 75 5 13 5 13 33 0 73 74 75 57 20 79 80 0 0 5 5 0 0 0 0 0 0 0 0 0 0 0 0 0 0 0 0 0 0 0 0 0 0 0 0 0 0 0 0 0 0 0 0 0 0 0 0 0 0 27 28 29 0 0 0 0 0 0 0 0 0 0 0 0 0 0 0 0 0 0 0 0 0 0 0 0 0 0 0 0 0 0 0 0 0 0 0 0 0 0 0 0 0 0 0 0 0 0 0 0 0 0 0 0 0 27 28 29 0 0 44 45 10 10 4 4 10 10 10 10 4 4 10 10 10 10 10 10 10 10 10 10 10 10 10 10 10 10 10 10 10 10 4 10 4 10 10 10 10 41 43 0 0 0 0 0 9 10 4 4 10 10 10 10 10 10 4 4 10 10 10 10 4 43 0 0 0 0 0 0 0 0 0 0 0 0 0 0 0 0 0 0 0 0 0 0 44 45 10 10 10 10 10 10 10 10 10 10 12 10 10 10 10 10 10 10 10 10 10 10 10 10 10 10 11 0 0 0 0 0 0 0 0 0 0 0 0 0 0 0 0 0 0 0 0 0 0 0 0 0 0 0 0 0 90 0 0 0 0 0 27 28 28 28 28 28 28 28 28 28 28 29 0 0 0 0 0 0 0 0 0 0 0 0 0 0 0 0 0 
59 59 59 59 59 59 59 59 59 59 59 59 59 59 59 59 59 59 59 59 59 59 59 59 59 59 59 59 59 59 59 59 59 59 59 59 59 59 59 59 59 59 59 92 39 39 39 92 59 59 59 59 59 83 6 7 7 7 7 7 7 7 7 7 59 59 59 59 59 59 59 59 59 59 59 59 59 6 7 7 7 7 7 8 69 70 26 26 26 26 26 26 26 26 26 26 69 70 1 2 2 2 2 2 2 2 2 2 2 2 2 2 2 2 2 2 2 2 2 2 2 2 0 0 0 0 0 0 0 0 0 0 0 0 0 0 0 0 0 0 0 0 0 0 0 0 0 0 0 0 0 0 0 0 0 0 0 0 0 0 0 0 0 0 0 0 0 0 0 0 0 0 0 0 0 0 0 0 0 0 0 0 0 0 0 0 0 0 0 0 0 0 0 0 0 0 0 0 0 0 0 0 0 0 0 0 0 0 0 0 0 0 0 0 0 0 0 0 0 0 0 0 44 45 10 10 4 10 10 12 10 10 10 10 10 10 10 10 10 10 10 10 10 10 10 10 10 12 12 10 10 12 10 10 10 4 4 10 10 41 43 0 0 0 0 0 0 9 10 4 10 10 10 10 10 10 10 10 10 10 10 10 41 43 0 0 0 0 0 0 0 0 0 0 0 0 0 0 0 0 0 0 0 0 0 0 0 0 44 45 10 10 10 10 10 4 10 10 10 10 10 10 10 10 10 10 10 10 10 10 10 10 10 10 10 11 32 0 0 0 0 0 0 0 0 0 0 0 0 0 0 0 0 0 0 0 0 0 0 0 0 0 0 0 0 20 0 0 0 0 0 0 63 64 37 59 59 59 59 59 37 59 53 0 0 0 0 0 0 0 0 0 0 0 0 65 66 67 0 0 
59 59 59 59 59 59 59 59 59 59 59 59 59 59 59 59 59 59 59 59 59 59 59 59 59 59 59 59 59 59 92 59 59 59 59 59 84 59 59 59 59 87 88 84 84 84 84 84 87 88 59 59 59 59 14 59 37 59 59 59 59 59 59 59 59 59 59 59 59 59 59 59 59 59 59 59 83 7 40 40 40 40 40 16 77 78 0 0 0 0 0 0 0 0 0 0 77 78 9 45 12 10 10 10 10 10 10 10 10 10 10 10 10 10 10 10 10 10 10 10 10 4 3 0 0 0 0 65 66 67 0 0 0 0 65 66 67 0 0 0 0 0 0 65 66 67 0 0 0 0 0 0 0 0 0 27 28 29 0 0 0 0 0 0 0 0 0 0 0 0 0 0 0 0 0 0 0 0 0 0 0 0 0 0 0 0 0 0 0 0 0 0 0 0 0 0 0 0 0 0 0 0 0 0 0 0 0 0 0 0 0 0 0 89 0 0 0 0 0 0 0 0 0 44 45 10 10 10 10 10 10 10 10 10 10 10 12 12 12 10 10 10 10 10 10 10 10 10 10 10 10 12 10 10 10 10 4 10 41 43 0 0 0 0 0 0 0 9 10 10 10 10 10 10 10 10 10 10 10 10 10 41 43 0 0 0 0 0 0 0 0 0 0 0 0 0 0 0 0 0 0 0 0 0 0 0 0 0 0 44 45 10 10 10 10 10 10 10 10 10 10 10 4 10 10 10 4 4 4 10 10 10 10 10 10 34 35 0 0 0 0 0 0 0 0 0 0 0 0 0 0 0 0 0 0 0 0 0 0 0 0 0 0 0 0 0 0 0 65 66 67 0 0 58 59 37 59 59 59 37 37 37 54 67 0 0 0 13 0 90 57 20 13 13 0 73 74 75 0 0 
59 59 59 59 59 59 59 59 59 59 59 59 59 59 59 59 59 59 59 59 59 59 59 59 59 59 59 59 59 59 84 59 59 59 59 59 59 59 59 59 59 6 84 84 84 84 84 84 84 8 59 59 59 59 14 59 37 59 59 59 59 59 59 59 59 59 59 59 59 59 59 59 59 59 59 59 59 59 59 59 59 36 40 16 0 0 0 0 0 0 0 0 0 0 0 0 0 0 9 12 10 10 10 10 10 10 4 10 10 4 4 4 10 10 4 4 10 10 10 10 4 10 10 3 0 57 13 73 74 75 0 5 13 13 73 74 75 33 0 13 0 33 0 73 74 75 13 13 33 0 0 0 0 0 0 0 0 0 0 0 0 0 0 0 0 0 0 0 0 0 0 0 0 0 0 0 0 0 0 0 0 0 0 0 0 0 0 0 0 0 0 0 0 0 0 0 0 0 0 0 0 0 0 0 0 0 0 0 0 0 0 0 27 28 29 0 0 0 0 0 0 0 0 0 9 10 10 10 10 10 10 10 10 10 12 12 12 12 10 10 10 10 10 10 10 10 10 10 10 10 10 12 41 18 18 18 18 18 43 0 0 0 0 0 0 0 0 9 4 10 10 10 12 4 4 10 10 10 10 10 41 43 0 0 0 0 0 0 0 0 0 0 0 0 0 0 0 0 0 0 0 0 0 0 0 0 0 0 0 0 44 18 18 45 10 10 4 10 10 10 12 12 10 12 10 10 10 10 10 10 10 4 10 10 10 11 0 0 0 0 0 0 0 0 0 0 0 0 0 0 0 0 0 0 0 0 0 0 0 0 0 0 0 0 0 0 0 0 73 74 75 13 60 61 59 59 59 59 59 37 37 37 52 53 33 13 1 2 2 2 2 2 2 2 2 2 2 2 2 2 
59 59 59 59 59 59 59 59 59 59 59 59 59 59 59 59 59 59 59 59 59 59 59 59 59 59 84 59 59 59 59 59 59 84 59 59 59 59 59 59 59 22 23 23 23 23 23 23 23 24 59 59 59 59 14 59 59 59 59 59 59 37 59 59 59 59 59 59 59 59 59 59 87 88 59 59 59 59 59 59 59 59 40 16 0 0 0 0 0 0 0 0 0 0 0 0 0 30 9 12 10 10 10 4 4 10 10 10 10 10 10 10 10 10 4 4 4 10 10 10 10 10 10 10 2 2 2 2 2 2 2 2 2 2 21 21 21 21 21 21 21 21 21 21 2 2 2 2 2 2 3 0 0 0 0 0 0 0 0 0 0 0 0 0 0 0 0 0 0 0 0 0 0 0 0 0 0 0 0 0 0 0 0 0 0 0 0 0 0 0 0 0 0 0 0 0 0 0 0 0 0 0 0 0 0 0 0 0 89 0 0 0 0 0 0 0 0 0 0 0 0 0 0 0 9 10 10 10 10 10 10 10 10 10 10 10 10 10 10 10 12 10 10 10 10 10 10 10 10 10 12 41 42 0 0 0 0 0 0 0 0 0 0 0 0 0 0 9 10 10 10 10 12 4 4 10 12 12 10 41 43 0 0 0 0 0 0 0 0 0 0 0 0 0 0 0 0 0 0 0 0 0 0 0 0 0 0 0 0 0 0 0 0 9 10 10 12 10 10 10 10 10 10 12 10 10 10 10 4 4 10 4 4 10 10 11 32 0 0 0 0 0 0 0 0 0 0 0 0 0 0 0 0 0 0 0 0 0 0 0 0 0 0 0 0 0 0 0 1 2 2 2 2 2 2 2 2 2 2 2 2 2 2 2 2 3 10 10 10 10 10 10 10 10 10 10 10 10 10 10 
59 59 59 59 59 59 39 39 87 88 59 94 94 59 87 88 92 92 92 39 92 92 92 59 59 59 59 59 59 59 59 59 59 59 59 92 59 59 59 59 59 59 59 59 59 59 59 59 59 59 59 59 59 59 14 37 59 59 59 59 59 59 59 59 59 59 59 59 59 59 59 59 59 59 59 59 59 59 59 59 37 59 40 16 0 0 0 0 0 0 0 0 0 0 0 0 0 0 9 10 10 10 10 10 10 10 10 10 10 10 10 10 12 12 12 12 4 10 10 10 10 10 10 10 10 9 11 4 10 10 10 10 10 10 10 10 10 10 10 10 10 10 10 10 10 10 10 10 10 10 34 35 0 0 0 0 0 0 0 0 0 0 0 0 0 0 0 0 0 0 0 0 0 0 0 0 0 0 0 0 0 0 0 0 0 0 0 0 0 0 0 0 0 0 0 0 0 0 0 89 0 89 0 0 0 0 27 28 29 0 0 0 0 0 0 0 0 0 0 0 0 0 0 0 9 10 10 10 10 10 4 4 10 10 10 10 10 10 10 10 12 12 10 10 10 10 10 10 10 12 12 42 0 0 0 0 0 0 0 0 0 0 0 0 0 0 0 9 10 10 10 4 4 10 10 10 4 12 10 11 0 0 0 0 0 0 0 0 0 0 0 0 0 0 0 0 0 0 0 0 0 0 0 0 0 0 0 0 0 0 0 0 30 9 10 10 12 10 10 10 12 12 10 10 10 10 10 10 10 10 10 12 12 10 10 11 32 0 0 0 0 0 0 0 0 0 0 0 0 0 0 0 0 0 0 0 0 0 0 0 0 0 0 0 0 0 0 0 9 10 10 10 10 10 10 10 10 10 10 10 10 10 10 10 10 10 10 10 10 10 10 10 10 10 10 10 10 10 10 10 
8 6 23 23 23 23 23 23 23 23 23 23 23 23 23 23 23 23 23 23 23 23 8 6 59 59 59 59 59 59 59 59 59 59 59 8 59 59 59 59 59 59 59 59 59 59 59 59 59 59 59 59 59 59 14 59 59 59 59 59 59 59 59 59 59 92 92 59 59 87 88 59 59 59 59 59 59 59 59 59 59 59 40 16 0 0 0 0 0 0 0 0 0 0 0 0 0 30 9 10 10 10 10 10 10 10 10 10 10 12 12 12 10 10 10 10 4 10 10 10 4 10 10 10 10 9 11 10 10 10 10 10 4 4 10 10 10 10 10 10 10 10 10 10 10 10 10 10 10 10 11 32 0 0 0 0 0 0 0 0 0 0 0 0 0 0 0 0 0 0 0 0 0 0 0 0 0 0 0 0 0 0 0 0 0 0 0 0 0 0 0 0 0 89 0 0 0 0 0 27 28 29 0 0 0 0 0 0 0 0 0 0 0 0 0 0 0 0 0 0 0 0 0 0 9 10 10 10 10 10 10 10 10 10 4 10 10 10 10 10 10 12 10 10 10 10 10 10 10 41 42 0 0 0 0 0 0 0 0 0 0 0 0 0 0 0 0 9 10 10 10 4 4 12 12 10 10 10 10 11 0 0 0 0 0 0 0 0 0 0 0 0 0 0 0 0 0 0 0 0 0 0 0 0 0 0 0 0 0 0 0 0 0 9 10 10 12 10 10 10 12 12 10 10 10 10 10 10 10 10 12 12 12 10 10 11 0 0 0 0 0 0 0 0 0 0 0 0 0 0 0 0 0 0 0 0 0 0 0 0 0 0 0 0 0 0 0 0 9 10 10 10 10 10 10 10 10 10 10 10 10 10 10 10 10 10 10 10 10 10 10 10 10 4 4 4 4 10 10 10 
16 59 59 59 59 59 59 59 59 59 59 59 59 59 59 59 59 49 50 0 0 0 16 14 59 59 59 59 59 59 59 59 59 59 59 16 59 59 59 59 59 59 59 59 59 59 59 59 59 59 59 59 59 59 14 37 37 59 59 59 59 59 59 59 59 87 88 59 59 59 59 59 59 37 37 59 59 59 59 59 59 59 40 16 0 0 0 0 0 0 0 0 0 0 0 0 0 30 9 10 10 10 10 10 10 10 10 10 10 10 10 10 10 10 10 10 4 10 10 10 10 10 10 10 10 9 11 10 10 10 10 10 10 10 10 4 4 10 10 10 10 10 10 10 10 10 12 10 10 10 11 0 0 0 0 0 0 0 0 0 0 0 0 0 0 0 0 0 0 0 0 0 0 0 0 0 0 0 0 0 0 0 0 0 0 0 0 57 0 0 0 0 27 28 29 0 0 0 0 0 0 0 0 0 0 0 0 0 0 0 0 0 0 0 0 0 0 0 0 0 0 0 0 0 9 10 10 10 10 10 10 10 10 10 10 10 10 10 10 10 12 10 10 10 10 10 10 10 41 42 0 0 0 0 0 0 0 0 0 0 0 0 0 0 0 0 0 9 10 10 10 4 4 12 12 10 10 10 10 11 0 0 0 0 0 0 0 0 0 0 0 0 0 0 0 0 0 0 0 0 0 0 0 0 0 0 0 0 0 0 0 0 0 9 10 10 4 4 4 4 10 10 10 10 10 10 10 4 4 4 4 12 12 10 10 34 35 0 0 0 0 0 0 0 0 0 0 0 0 0 0 0 0 0 0 0 0 0 0 0 0 0 0 0 0 0 0 0 9 10 10 10 10 10 10 10 10 10 10 10 10 10 10 10 10 4 4 4 4 10 10 10 10 10 10 10 10 10 10 10 
16 59 59 37 59 59 59 37 59 59 59 59 59 59 37 59 49 50 0 0 0 0 16 14 82 59 59 59 59 59 59 59 59 59 83 16 82 59 59 59 59 59 59 59 59 59 59 59 59 59 59 59 59 91 14 59 37 59 59 59 59 92 92 59 59 59 59 59 59 59 59 59 59 59 59 59 59 59 59 59 59 59 40 16 0 0 0 0 0 0 0 0 0 0 0 0 0 0 9 10 10 12 12 10 10 10 10 10 10 10 10 10 10 10 10 10 4 10 10 10 10 10 10 10 10 9 11 10 10 10 10 12 12 12 10 10 4 4 10 10 4 4 10 10 10 10 10 10 10 10 11 32 0 0 0 0 0 0 0 0 0 0 0 0 0 0 0 0 0 0 0 0 0 0 0 0 0 0 0 0 0 0 0 0 0 27 28 28 28 29 0 0 0 0 0 0 0 0 0 0 0 0 0 0 0 0 0 0 0 0 0 0 0 0 0 0 0 0 0 0 0 0 0 0 9 10 12 10 10 10 10 10 10 10 10 10 4 10 10 10 4 10 10 10 10 10 10 41 42 0 0 0 0 0 0 0 0 0 0 0 0 0 0 0 0 0 0 9 10 4 12 4 4 12 12 10 4 10 10 11 0 0 0 0 0 0 0 0 0 0 0 0 0 0 0 0 0 0 0 0 0 0 0 0 0 0 0 0 0 0 0 0 30 9 10 4 10 10 10 10 4 4 12 12 10 10 12 12 12 12 4 10 10 10 10 34 35 0 0 0 0 0 0 0 0 0 0 0 0 0 0 0 0 0 0 0 0 0 0 0 0 0 0 0 0 0 0 0 9 10 10 10 10 10 10 10 10 4 4 4 4 4 12 12 12 10 10 10 10 10 10 12 12 10 10 10 10 12 10 10 
16 59 59 59 59 59 59 37 37 59 59 59 59 59 59 49 50 0 0 0 0 0 16 14 59 59 59 59 59 59 59 59 59 59 59 16 59 59 37 59 59 37 59 59 37 59 59 37 37 37 59 59 59 83 14 59 59 59 59 59 59 87 88 59 59 59 59 59 59 59 59 59 59 59 59 59 59 59 59 59 59 59 40 16 0 0 0 0 0 0 0 0 0 0 0 0 0 0 9 10 10 10 12 12 10 10 10 10 10 10 10 10 10 10 10 10 10 10 10 10 4 10 10 10 10 9 11 10 10 12 10 10 10 10 10 10 10 10 10 10 10 10 10 10 10 10 10 10 10 10 34 35 0 0 0 0 0 0 0 0 0 0 0 0 0 0 0 0 0 0 0 0 0 0 0 0 0 0 0 0 0 0 0 0 0 0 0 0 0 0 0 0 0 0 0 0 0 0 0 0 0 0 0 0 0 0 0 0 0 0 0 0 0 0 0 0 0 0 0 0 0 0 0 0 9 10 12 10 10 10 10 10 10 10 10 10 4 4 10 4 4 10 10 12 10 10 41 42 0 0 0 0 0 0 0 0 0 0 0 0 0 0 0 0 0 0 0 9 10 10 12 10 10 12 12 10 4 12 10 11 0 0 0 0 0 0 0 0 0 0 0 0 0 0 0 0 0 0 0 0 0 0 0 0 0 0 0 0 0 0 0 0 30 9 10 10 10 10 10 10 4 4 10 10 10 10 10 10 10 10 10 10 10 10 10 11 0 0 0 0 0 0 0 0 0 0 0 0 0 0 0 0 0 0 0 0 0 0 0 0 0 0 0 0 0 0 0 0 9 10 10 10 10 4 4 10 10 10 10 10 10 10 10 10 10 10 10 10 10 10 10 12 12 10 10 10 10 10 10 10 
16 59 59 59 59 59 59 59 37 59 59 59 59 59 49 43 0 0 0 0 0 0 16 14 39 39 39 39 39 39 39 39 39 39 39 16 59 59 84 59 59 59 59 59 59 59 59 59 59 84 59 59 59 59 14 59 59 59 20 59 59 59 59 59 59 59 59 59 59 59 59 59 59 59 59 59 59 59 37 37 59 59 40 16 0 0 0 0 0 0 0 0 0 0 0 0 0 0 9 10 10 10 12 10 10 10 10 10 10 4 4 12 10 10 10 10 10 10 12 12 4 10 10 10 10 9 11 10 10 12 10 10 10 10 10 10 10 10 10 10 10 10 10 10 10 12 12 10 10 10 34 35 0 0 0 0 0 0 0 0 0 0 0 0 0 0 0 0 0 0 0 0 0 0 0 0 0 0 0 0 0 0 0 0 0 0 0 0 0 0 0 0 0 0 0 0 0 0 0 0 0 0 0 0 0 0 0 0 0 0 0 0 0 0 0 0 0 0 0 0 0 0 0 0 9 10 10 10 10 10 12 12 12 12 12 10 10 10 10 10 10 10 12 10 10 10 11 0 0 0 0 0 0 0 0 0 0 0 0 0 0 0 0 0 0 0 0 9 10 10 12 10 10 4 12 10 4 12 10 11 0 0 0 0 0 0 0 0 0 0 0 0 0 0 0 0 0 0 0 0 0 0 0 0 0 0 0 0 0 0 0 0 0 9 10 10 10 10 10 10 10 10 10 10 12 12 12 10 10 10 10 10 10 10 10 11 0 0 0 0 0 0 0 0 0 0 0 0 0 0 0 0 0 0 0 0 0 0 0 0 0 0 0 0 0 0 0 0 9 10 10 10 10 4 4 12 10 10 10 10 10 10 10 10 10 10 10 10 10 10 10 10 10 10 10 10 10 10 10 10 
16 59 59 59 59 59 59 37 37 59 59 59 59 49 43 0 0 0 0 0 0 0 16 22 84 84 84 84 84 84 84 84 84 84 84 24 59 37 59 59 59 84 59 59 59 94 59 59 59 59 59 37 37 59 14 59 59 59 59 59 59 59 59 59 59 59 59 37 59 59 37 37 59 59 59 59 59 59 59 59 59 59 40 16 0 0 0 0 0 0 0 0 0 0 0 0 0 0 9 10 10 12 12 10 10 10 10 10 10 10 10 10 10 10 10 10 10 10 12 10 10 10 10 10 10 9 11 10 10 10 10 10 10 10 10 10 10 10 10 10 10 10 10 10 10 4 4 10 10 10 11 0 0 0 0 0 0 0 0 0 0 0 0 0 0 0 0 0 0 0 0 0 0 0 0 0 0 0 0 0 0 0 0 0 0 0 0 0 0 0 0 0 0 0 0 0 0 0 0 0 0 0 0 0 0 0 0 0 0 0 0 0 0 0 0 0 0 0 0 0 0 0 0 0 9 10 10 10 10 10 10 10 10 10 10 10 10 10 10 10 10 10 12 10 10 10 11 0 0 0 0 0 0 0 0 0 0 0 0 0 0 0 0 0 0 0 0 9 10 10 12 10 10 4 10 10 10 10 10 11 0 0 0 0 0 0 0 0 0 0 0 0 0 0 0 0 0 0 0 0 0 0 0 0 0 0 0 0 0 0 0 0 30 9 10 10 12 10 10 10 10 10 10 10 12 12 12 10 10 10 10 12 10 4 10 11 0 0 0 0 0 0 0 0 0 0 0 0 0 0 0 0 0 0 0 0 0 0 0 0 0 0 0 0 0 0 0 0 9 10 10 10 10 10 10 10 10 10 10 10 10 10 10 10 10 10 10 10 10 10 10 10 10 10 10 10 12 12 10 10 
16 59 59 37 59 59 37 37 59 59 59 59 49 50 0 0 0 0 0 0 0 0 22 23 23 23 23 23 23 23 23 23 23 23 23 8 59 37 37 59 59 59 59 59 59 84 59 59 59 59 59 59 59 59 14 82 59 59 59 59 59 59 59 59 59 59 59 59 59 59 59 59 59 59 59 59 59 59 59 59 59 59 40 16 0 0 0 0 0 0 0 0 0 0 0 0 0 0 9 10 10 10 10 10 10 10 10 10 10 10 10 10 10 10 10 10 10 10 10 10 10 10 10 10 10 9 11 10 10 10 12 12 10 10 10 10 12 10 10 12 12 10 10 10 10 10 10 10 10 10 11 0 0 0 0 0 0 0 0 0 0 0 0 0 0 0 0 0 0 0 0 0 0 0 0 0 0 0 0 0 0 0 0 0 0 0 0 0 0 0 0 0 0 0 0 0 0 0 0 0 0 0 0 0 0 0 0 0 0 0 0 0 0 0 0 0 0 0 0 0 0 0 0 0 9 10 10 10 4 10 10 10 10 10 10 10 10 10 10 10 10 10 12 10 10 10 11 0 0 0 0 0 0 0 0 0 0 0 0 0 0 0 0 0 0 0 0 9 10 10 4 10 10 10 10 10 4 10 10 11 0 0 0 0 0 0 0 0 0 0 0 0 0 0 0 0 0 0 0 0 0 0 0 0 0 0 0 0 0 0 0 0 30 9 10 10 12 10 10 10 10 10 10 10 10 10 10 10 10 12 10 12 10 4 10 34 35 0 0 0 0 0 0 0 0 0 0 0 0 0 0 0 0 0 0 0 0 0 0 0 0 0 0 0 0 0 0 0 9 10 10 10 10 10 10 10 10 10 4 10 10 10 10 10 10 10 10 10 10 10 10 10 10 10 10 10 12 12 4 4 
16 59 59 59 59 59 59 37 59 59 59 49 50 0 0 0 0 0 0 0 0 0 0 0 0 0 0 0 0 0 0 63 64 59 59 16 59 59 59 59 59 59 59 59 59 59 59 59 37 59 59 59 59 59 14 71 72 59 59 59 59 59 59 59 59 59 59 59 59 59 91 59 59 59 59 92 92 59 59 59 92 92 40 16 0 0 0 0 0 0 0 0 0 0 0 0 0 0 9 10 10 10 10 10 10 4 10 10 10 10 10 10 10 10 10 10 10 10 10 10 12 12 12 12 10 9 11 10 10 10 10 10 10 10 10 12 12 10 10 10 10 10 10 10 10 10 10 12 10 12 11 0 0 0 0 0 0 0 0 0 0 0 0 0 0 0 0 0 0 0 0 0 0 0 0 0 0 0 0 0 0 0 0 0 0 0 0 0 0 0 0 0 0 0 0 0 0 0 0 0 0 0 0 0 0 0 0 0 0 0 0 0 0 0 0 0 0 0 0 0 0 0 0 0 9 10 10 10 10 10 10 10 4 4 10 10 10 10 10 10 12 12 10 10 10 10 11 0 0 0 0 0 0 0 0 0 0 0 0 0 0 0 0 0 0 0 0 9 10 10 10 10 4 12 10 10 10 10 10 11 0 0 0 0 0 0 0 0 0 0 0 0 0 0 0 0 0 0 0 0 0 0 0 0 0 0 0 0 0 0 0 0 30 9 10 12 10 12 12 12 12 12 12 10 10 10 10 10 10 12 10 10 12 12 10 11 0 0 0 0 0 0 0 0 0 0 0 0 0 0 0 0 0 0 0 0 0 0 0 0 0 0 0 0 0 0 0 0 9 10 10 10 10 10 4 10 10 10 4 10 10 10 10 10 10 10 12 12 12 12 10 10 10 10 10 12 10 10 4 4 
16 59 59 59 37 37 37 37 59 59 59 51 0 0 0 0 0 0 0 0 0 0 0 0 0 0 0 0 0 0 0 0 63 64 59 16 39 39 39 39 39 39 39 39 39 39 39 39 39 39 39 39 39 39 14 79 80 20 39 59 87 88 39 39 39 87 88 39 39 39 87 88 39 39 39 87 88 39 39 39 87 88 40 16 0 0 0 0 0 0 0 0 0 0 0 0 0 0 9 10 10 10 10 10 4 4 10 4 10 10 4 4 10 10 10 10 10 10 10 10 10 10 10 10 10 9 11 10 10 10 10 10 10 10 10 10 10 10 10 10 10 10 10 10 10 10 10 10 10 12 34 35 0 0 0 0 0 0 0 0 0 0 0 0 0 0 0 0 0 0 0 0 0 0 0 0 0 0 0 0 0 0 0 0 0 0 0 0 0 0 0 0 0 0 0 0 0 0 0 0 0 0 0 0 0 0 0 0 0 0 0 0 0 0 0 0 0 0 0 0 0 0 0 0 9 10 10 10 10 10 12 12 12 12 10 10 10 10 12 12 12 10 10 10 10 10 11 0 0 0 0 0 0 0 0 0 0 0 0 0 0 0 0 0 0 0 0 9 10 10 10 10 12 12 10 10 10 10 10 11 0 0 0 0 0 0 0 0 0 0 0 0 0 0 0 0 0 0 0 0 0 0 0 0 0 0 0 0 0 0 0 0 0 9 10 10 10 10 10 10 10 10 10 10 10 4 4 4 12 12 12 12 12 12 10 11 0 0 0 0 0 0 0 0 0 0 0 0 0 0 0 0 0 0 0 0 0 0 0 0 0 0 0 0 0 0 0 0 9 10 10 10 10 10 10 10 10 10 10 10 10 10 10 10 10 10 10 10 10 10 10 10 10 10 10 10 10 10 4 4 
24 18 18 18 18 18 18 18 18 18 18 43 0 0 0 0 0 0 0 0 0 0 0 0 0 0 0 0 0 0 0 0 0 63 64 22 23 23 23 23 23 23 23 23 23 23 23 23 23 23 23 23 23 23 23 23 23 23 23 23 23 23 23 23 23 23 23 23 23 23 23 23 23 23 23 23 23 23 23 23 23 23 23 24 0 0 0 0 0 0 0 0 0 0 0 0 0 0 17 18 18 18 18 18 18 18 18 18 18 18 18 18 18 18 18 18 18 18 18 18 18 18 18 18 18 17 19 18 18 18 18 18 18 18 18 18 18 18 18 18 18 18 18 18 18 18 18 18 18 18 19 0 0 0 0 0 0 0 0 0 0 0 0 0 0 0 0 0 0 0 0 0 0 0 0 0 0 0 0 0 0 0 0 0 0 0 0 0 0 0 0 0 0 0 0 0 0 0 0 0 0 0 0 0 0 0 0 0 0 0 0 0 0 0 0 0 0 0 0 0 0 0 0 0 9 10 10 10 10 10 10 10 10 10 10 10 10 10 10 10 10 10 10 10 10 10 11 0 0 0 0 0 0 0 0 0 0 0 0 0 0 0 0 0 0 0 0 9 10 10 10 10 10 10 10 10 10 10 10 11 0 0 0 0 0 0 0 0 0 0 0 0 0 0 0 0 0 0 0 0 0 0 0 0 0 0 0 0 0 0 0 0 0 9 10 10 10 12 10 12 12 12 10 10 10 10 10 10 10 10 10 10 10 10 10 11 0 0 0 0 0 0 0 0 0 0 0 0 0 0 0 0 0 0 0 0 0 0 0 0 0 0 0 0 0 0 0 0 9 10 10 10 10 10 10 10 10 10 10 10 10 10 10 10 10 10 10 10 10 10 10 10 10 10 10 10 10 10 10 10